1111111000101000101111111
1000001010100001101000001
1011101000001010101011101
1011101011101111001011101
1011101001000100101011101
1000001011011011101000001
1111111010101010101111111
0000000001110010000000000
1111101111010111110101010
1101010110101000100100010
0001111100100011100001011
1011000010001010011100001
0001011001101111111110111
1111010011000010100101010
1010101111111101110111011
1010110111010011000110001
1000101001111101111110100
0000000010101101100011000
1111111010100110101010111
1000001000100000100011011
1011101011011111111110100
1011101011010000011011111
1011101010000100110001101
1000001010110011100111001
1111111010111110011111111
